   R   640   360
NO        ./textures/wall_no.xpm
SO  ./textures/wall_so.xpm
WE   ./textures/wall_we.xpm
EA     ./textures/wall_ea.xpm

S ./textures/sprite1.xpm
S2 ./textures/sprite2.xpm
F 25, 35, 25
C    50 , 70  ,   120

        1111111111111111111111111111111111111111111111111111
        10000000000000000303000000000001100000000000000000111
        10202000000000000000000000000001100200000000000000111
1111111110000000000111111101110000000000000000000000000000011
1003000300000000011100000000010000000000000000000000000000301
1020200000000001110000110000010200000000000000000000000000301
1020000000000011000001100000010000000000000000000000000000011
130000000000011103000111000011020000000000000000000000001111
130000000000001100000000330110000000000000000000000000030001
130000000000000110111111111102000000000000000000000000002011
100000000000000000000000000000000000000000000000000000000011
100000000000000000002000200000000000000000000000000000002011
100000000000000000200020002000000000000000000000000000030011
100000000000000000030030030000000000000000000000000000001111
100000000000000000020002000200000100000000000000000000111111
100000000000000000000200020000301100000000000000000000001111
100000000000000000000000000003011030000000000000000000000011
100000000000000000000000000000111030000000000000000000003011111
100000000000000000000000000003011100000000000000000000003000011
100000000000000000000000000000000000000000000000000000003011111
100000000000000000000000000000000000000000000000000000000011
100000000000000000202020202020202020200000000000000000000011
100000000000000000000000033333333330000000000000000000000011
10N000000000000000202020202020202020202020000000000000000111
10000000000000000000000000000000000000000000000000000000011
1111111111111111111111111111111111111111111111111111111111
