   R   640  360
NO        ./textures/wall_no.xpm
SO  ./textures/wall_so.xpm
WE   ./textures/wall_we.xpm
EA     ./textures/wall_ea.xpm

S ./textures/sprite1.xpm
S2 ./textures/gem.xpm
S3 ./textures/map.xpm
F 25, 35, 25
C    50 , 70  ,   120

        11111111111111111111111111111111111111111111111111111111
        10000000000000000200000000110000000000000000000000000011
        10200000000000000000000000110020000000000000000000000011
1111111110000000000000000000000000110000000010000000000000000011
1000000000000000010000000000001111100000000010000000000000000011
1020200000000000011000000000000000000000000010000020011111111111
10200000000000000111000000000000000000011111111111111100011
10000000000000000111110000000000000000001000000000000000011
10000000000000000111000000000000000000002000333000000000111
100000000000000001100000000000000000000010000333000000011
10000000000000011111100000000000000000001000333000000011
10000000000000100000100000000000000000001111122111111111
10000000000000111000100000000000000000000000000000000011
10000000000000001000100000000000000000000000000000000011
10000000001111111000100000000000200000000020000000000011
10000000011000000000110000000000000000000000000000000111
10000000010000010000010000000000200000000020000000000111
10000000010001111100110000000000000000000000300000000111
10000000010001001000100000000000200000000020000000000011
11111111110001001000100000000000000000000000000000000011
  100000001110000000100000000000200000000020000000000011
  103000000000000000100000000000000000000000000000000011
  100000000000001000100000000000200000000020000000000011
111121111100000001000100000000000000000000000000000000011
10000000011000001001000000000000000000000000000000000011
10000003001100001000000000000000000000000000000000000011
12000000000111111111000000000000000000000000000000000011
1000000000011100001000000000000000000000000000000000011
12000000000011100001111111111111111100011111111111111111
10000000000000000001000000000000000000000000000000111
1000000000000000000000000000000000000000000000002011
1000000000000000000000000000000000000000000040020011
100000000000000000010000000000000000000000000020011
10000000000000000001000000000000000000000000000011
1111111111111111111111111111111111111111111111111
