   R   640   360
NO        ./textures/wall_no.xpm
SO  ./textures/wall_so.xpm
WE   ./textures/wall_we.xpm
EA     ./textures/wall_ea.xpm

S ./textures/sprite1.xpm
F 25, 35, 25
C    50 , 70  ,   120

        111111111111111111111
        1000000000000000000011111111111
        1020000000000000000000000000001
111111111000000000000000000000000000001
100200000000000111000000000011111111111
10000000000000011100000000001
10000000200000011100000000001
10000000000000000000000000001
10000200000000000000000001111
10N00000000000000000000001
10000000000000000000000011
1111111111111111111111111
