   R   640   360
NO        ./textures/wall_no.xpm
SO  ./textures/wall_so.xpm
WE   ./textures/wall_we.xpm
EA     ./textures/wall_ea.xpm

S ./textures/sprite1.xpm
F 25, 35, 25
C    50 , 70  ,   120

        111111111111111111111
        100000000000000000001
        102000000000000000001
11111111100000000000000000001
10020000000000011100000000001
10000000000000011100000000001
10000000200000011100000000001
10000000000000000000000000001
10000200000000000000000001111
10N00000000000000000000001
10000000000000000000000011
1111111111111111111111111
