   R   1280   720
NO        ./textures/wall_no.xpm
SO  ./textures/wall_so.xpm
WE   ./textures/wall_we.xpm
EA     ./textures/wall_ea.xpm

S ./textures/sprite1.xpm
F 25, 35, 25
C    50 , 70  ,   120

        1111111111111111111111111111111111111111111
        1000000000000000000001000000000110000000111
        1020000000000000000001001000000110020000111
1111111110000000000000000000010111111000000000000011
1000000000000000000000002000010000001000000000000011
1002000000000001110000000000011111111000000000200011
100000000000000111000000000000000000000000000000011
100000002000000111000000000000000000000000000011111
100000000000000000000000000000000200000000000000011
100002000000000000000000000000000000000000000000111
100000000000000000000000000000000000000000000000111
100000000000000000000000000000000000000000000000111
100000000000000000000000000000000000000000000000111
100000000000000000000000000000000000000000000011111
100000000000000000000000000200000000000000001111111
100000000000000000000000000000000000000000000011111
100000000000000000000000000000011000000000000000111
100000000000000000000000000000111000000000000000111
100000000000000200000000000000011100000000000000111
100000000000000000000000000000000000000000000000111
100000000000000000000000000000000000000000000000111
100000000000000000000000000020000000000000000000111
10000000000000000000000000000000000000000200000111
10N000000000000000000000000000000000000200020111
100000000000000000000000000000000000000000000011
111111111111111111111111111111111111111111111111
