   R   1280   720
NO        ./textures/wall_no.xpm
SO  ./textures/wall_so.xpm
WE   ./textures/wall_we.xpm
EA     ./textures/wall_ea.xpm

S ./textures/sprite1.xpm
S2 ./textures/sprite2.xpm
F 25, 35, 25
C    50 , 70  ,   120

        1111111111111111111111111111111111111111111
        1000000000000000030300000000000110000000111
        1020200000000000000000000000000110020000111
1111111110000000000001111101110000000000000000000011
1003000300000000000111000000010000000000000000003011
1020200000000001111111000000010200000000000000003011
102000000000001100000000000001000000000000000000011
130000000000011103000000000011020000000000000011111
130000000000001100000000330110000000000000000300011
130000000000000110111111111102000000000000000020111
100000000000000000000000000000000000000000000000111
100000000000000000002000200000000000000000000020111
100000000000000000200020002000000000000000000300111
100000000000000000000000000000000000000000000011111
100000000000000000020002000200000100000000001111111
100000000000000000000200020000301100000000000011111
100000000000000000000000000003011030000000000000111
100000000000000000000000000000111030000000000030111
100000000000000000000000000003011100000000000030111
100000000000000000000000000000000000000000000030111
100000000000000000000000000000000000000000000000111
100000000000000000202020202020202020200000000000111
100000000000000000000000030303030303030000000000111
10N00000000000000020202020202020202020202000000111
1000000000000000000000000000000000000000000000011
111111111111111111111111111111111111111111111111
