   R   640   360
NO        ./textures/wall_no.xpm
SO  ./textures/wall_so.xpm
WE   ./textures/wall_we.xpm
EA     ./textures/wall_ea.xpm

S ./textures/sprite1.xpm
S2 ./textures/sprite2.xpm
F 25, 35, 25
C    50 , 70  ,   120

        1111111111111111111111111111111111111111
        100000000000000003030000001100000000000011111
        1020200000000000000000000011002000000000111111111
111111111000000000011111110111000000000000000000000000011111
100300030000000001110000000001000000000000030000000000000011111
102020000000000111000011000001020000000000030000001111100000111111
10200000000000110000011000000100000000000000111111111111000000011111
130000000000011103000111000011020000000001111       111110000000011111
130000000000001100000000330110000000000030001      110000000000000000011
13000000000000011011111111110200000000000201111111111110000000000000001111
10000000000000000000000000000000000000000000000000000000000000000000000001
10000000000000000000000020000000000000000201111111000000000000000000000001
100000000000000000000020002000000000000030011    1000000000000000000000001
100000000000000000030030030000000000000001111    11000000000000000000000011
100000000000000000020002000000000100000111111     1100000000000000000000001
100000000000000000000200000000301100000001111      111000000000000000000001
100000000000000000000000000003011030000000000000000000000000000000000000001
100000000000000000000000000000111030000003011      111000000000000000000001
100000000000000000000000000003011100000003001     1110000000000000000000001
100000000000000000000000000000000000000003011    11000000000000000000000001
100000000000000000000000000000000000000000011    10000000000000000000000001
100000000000000000000000000000000000000000011    10000000000000000000000001
100000000000000000000000000000000000000000011    10000000000000000000000001
100000000000000000000000000000000000000000011    10000000000000000000000001
100000000000000000000000000000000000000000011    10000000000000000000000001
100000000000000000000000000000000000000000011    10000000000000000000000001
100000000000000000000000000000000000000000011    10000000000000000000000001
100000000000000000000000000000000000000000011    10000000000000000000000001
100000000000000000000000000000000000000000011111110000000000000000000000001
100000000000000000000000000000000000000000000000000000000000000000000000001
10000000000000000020002000202020202020000000000000000000000000000000000011
10000000000000000000000000003030300000000000000000000000000000000000000111
1000000000000000000000000003030303000000000000000000011111110000000011111
10N000000000000000200020002020202020202020111111111111111100000000011111
1000000000000000000000000000000000000000000000000000000000000000011111
100000000000000000000000000000000000000000000000000000000000001111
111111111111111111111111111111111111111111111111111111111111111
