   R   640   360
NO        ./textures/wall_no.xpm
SO  ./textures/wall_so.xpm
WE   ./textures/wall_we.xpm
EA     ./textures/wall_ea.xpm

S ./textures/sprite1.xpm
S2 ./textures/sprite2.xpm
F 25, 35, 25
C    50 , 70  ,   120

        11111111111111111111111111111111111111111111111
        100000000000000003030000000000011000000000000111
        102020000000000000000000000000011002000000000111
11111111100000000001111111011100000000000000000000000011
10030003000000000111000000000100000000000000000000000301
10202000000000011100001100000102000000000000000000000301
10200000000000110000011000000100000000000000000000000011
1300000000000111030001110000110200000000000000000001111       111111111111111111
1300000000000011000000003301100000000000000000000030001      110000000000000000011
130000000000000110111111111102000000000000000000000201111111111110000000000000001111
100000000000000000000000000000000000000000000000000000000000000000000000000000000001
100000000000000000000000200000000000000000000000000201111111000000000000000000000001
1000000000000000000000200020000000000000000000000030011    1000000000000000000000001
1000000000000000000300300300000000000000000000000001111    11000000000000000000000011
1000000000000000000200020000000001000000000000000111111     11000000000000000000000011
1000000000000000000002000000003011000000000000000001111      1110000000000000000000011
1000000000000000000000000000030110300000000000000000011      11111000000000000000000011
1000000000000000000000000000001110300000000000000003011      11100000000000000000000111
1000000000000000000000000000030111000000000000000003001     111000000000000000000000111
1000000000000000000000000000000000000000000000000003011    110000000000000000000000111
1000000000000000000000000000000000000000000000000000011    10000000000000000000000011
100000000000000000200020002020202020200000000000000001111111000000000000000000000011
100000000000000000000000000030303000000000000000000000000000000000000000000000000111
10000000000000000000000000030303030000000000000000000000000000011111111111111111111
10N0000000000000002000200020202020202020200000000000111111111111111111111111111111
100000000000000000000000000000000000000000000000000011
100000000000000000000000000000000000000000000000000011
11111111111111111111111111111111111111111111111111111
