   R   640   360
NO        ./textures/wall_no.xpm
SO  ./textures/wall_so.xpm
WE   ./textures/wall_we.xpm
EA     ./textures/wall_ea.xpm

S ./textures/sprite1.xpm
S2 ./textures/sprite2.xpm
F 25, 35, 25
C    50 , 70  ,   120

        11111111111111111111111111111111111111111111111111111111
        10000000000000000303000000110000000000000000000000000011
        10202000000000000000000000110020000000000000000000000011
1111111110000000000000000000000000110000000010000000000000003011
1003000300000000010000000000001111100000000010000000000000000011
1020200000000000011000000000000000000000000010000000011111111111
10200000000000000111000000000000000000011111111111111100011
13000000000000000111110000000000000000000000000000000000011
13000000000000000111000000000000000000000000000000000000111
130000000000000001100000000000000000000000000000000000011
10000000000000011111100000000000000000000000000000000011
10000000000000100000100000000000000000000000000000000011
10000000000000111000100000000000000000000000000000000011
10000000000000001000100000000000000000000000000000000011
10000000001111111000100000000000200000000020000000000011
10000000011000000000110000000000000000000000000000000111
10000000010000010000010000000000200000000020000000000111
10000000010001111100110000000000000000000000000000000111
10000000010001001000100000000000200000000020000000000011
11111111110301001000100000000000000000000000000000000011
  100000001110000000100000000000200000000020000000000011
  100000000000000000100000000000000000000000000000000011
  100000000000001000100000000000200000000020000000000011
  100000000000001000100000000000000000000000000000000011
  100000000000001001000000000000000000000000000000000011
  100020000020001000000000000000000000000000000000000011
11111111111111111111000000000000000000000000000000000011
1002000000311100001000000000000000000000000000000000011
12000000000001000001111111111111111100011111111111111111
10000000000000000001000000000000000000000000000000111
1000000000000000000000000000000000000000000000002011
1000000000000000000000000000000000000000000000020011
10N000000000000000010000000000000000000000000020011
10000000000000000001000000000000000000000003000011
1111111111111111111111111111111111111111111111111
