   R   1280   720
NO        ./textures/wall_no.xpm
SO  ./textures/wall_so.xpm
WE   ./textures/wall_we.xpm
EA     ./textures/wall_ea.xpm

S1 ./temp1
S2 ./temp2
F 70, 210, 150
C    50 , 70  ,   120

        11111111111111111111111
        10000000000110000000111
        10000000000110000000111
1111111110000000000000000001111
1000000000000000000000000001111
1000000000000001110000000001111
1000000000000001110000000001111
10000000000000011100000000011
10000000000000000000000000011
10000000000000000000000000111
10000000000000000000000011111
100000000000000000000001111
10N000000000000000000000111
100000000000000000000000011
111111111111111111111111111
