   R   1280   720
NO        ./textures/wall_no.xpm
SO  ./textures/wall_so.xpm
WE   ./textures/wall_we.xpm
EA     ./textures/wall_ea.xpm

S ./temp
F 70, 210, 150
C    50 , 70  ,   120

          11111111111111111111
          10000000000110000001
          10000000000110000001
111111111110000000000000000001
100000000000000000000000000001
100000000000000011100000000001
100000000000000011100000000001
100000000000000011100000000001
100000000000000000000000000011
10000000000000000000000000011
1000000000000000000000000111
1000000000000000000000001111
100N000000000000000000000111
1000000000000000000000000011 
1111111111111111111111111111
